XXXXXXXXXXXXXXXXXXXXXXXXXXX
XWWWWWWWWWWWWWWWWWWWWWWWWWX
XWFFFFFFFFFFFWFFFFFFFFFFFWX
XWFWWWWFWWWWFWFWWWWFWWWWFWX
XWFFFFWFWWWWFWFWWWWFWFFFFWX
XWFWWCWFFFFFFFFFFFFFWBWWFWX
XWFWWWWFWFWWWWWWWFWFWWWWFWX
XWFFFFFFWFFFFWFFFFWFFFFFFWX
XWWWWWWFWWWWFWFWWWWFWWWWWWX
XW1XXXWFWFFFFFFFFFWFWXXXXWX
XWXXXXWFWFWWWGWWWFWFWXXXXWX
XWWWWWWFWFW0LER2WFWFWWWWWWX
DDFFFFFFFFWLLERRWFFFFFFFFDD
XWWWWWWFWFWLEWERWFWFWWWWWWX
XWXXXXWFWFWWWWWWWFWFWXXXXWX
XWXXXXWFWFFFFPFFFFWFWXXXXWX
XWWWWWWFWWWWFWFWWWWFWWWWWWX
XWFFFFFFWFFFFWFFFFWFFFFFFWX
XWFWWWWFWFWWWWWWWFWFWWWWFWX
XWFWWBWFFFFFFFFFFFFFWCWWFWX
XWFFFFWFWWWWWFWWWWWFWFFFFWX
XWFWWWWFWWWWWFWWWWWFWWWWFWX
XWFFFFFFFFFFFFFFFFFFFFFFFWX
XWWWWWWWWWWWWWWWWWWWWWWWWWX
XXXXXXXXXXXXXXXXXXXXXXXXXXX